R 5000 5000
F 0,255,255
C 255,0,255
NO ./textures/colorstone.xpm
SO ./textures/eagle.xpm
WE ./textures/bluestone.xpm
EA ./textures/redbrick.xpm
S  ./textures/pillar.xpm




111
                         
11111111111111111111111111111111111111
11111111111111000000000110000000000001
10110000011100000020000011111111111111
100100000000000000000000111111111
11111111011000001110000000000001
11000000000110000011101111111111
11110111111111011100000010001
11110111111111011100010010001   
111111111111111111101111111111
111111111111111111101111111111    
110000001101010111000000100011
100022000000000000000000100011
100000000000000011011110000001
11002201110101011111011110S011
111101111111010111011110100011
111111111 111111 1111111111111
