R 100 720
C 255,200,160
F 122,122,122

NO ./textures/barrel.xpm
SO ./textures/barrel.xpm
WE ./textures/barrel.xpm
EA ./textures/barrel.xpm
S  ./textures/barrel.xpm

        1111111111111111111111111
        1000000000110000000000001
        1011000001110000002000001
        1001000000000000000000001
111111111011000001110000000000001
100000000011000001110111111111111
11110111111111011100000010001
11110111110101011101010010001
11000000111111011100000010001
10002000000100001100000010001
10000000000000001101010010001
11000001110101011111011110N0111
11110111 1110101 101111010001
11111111 1111111 111111111111
